#####   
#   #   
#   ####
#P     #
##### ##
#      #
########