#####   
#   #   
#   ####
#P     #
#     ##
#      #
########